8 6
1200 300
1 2 1 2 1 2 1 2
3 4 3 4 3 4 3 4
0 0 1 2 0 0 0 0
0 0 3 4 0 0 0 0
0 0 1 2 0 0 0 0
0 0 3 4 0 0 0 0
